#
#
#
#
#
#
==========================================================
                                                        ==
                                         =====           =
                                     *                   =
                         * * *    ====                   =
                         ========                        =
                                                      ====
                                         =====           =
                                     *                   =
                         * * *      ====                 =
                                                        ==
                                         =====           =
                                     *                   =
                         * * *    ====                   =
                         ========                        =
                                                      ====
                                         =====           =
                                     *                   =
                         * * *      ====                 =
                                                        ==
                                         =====           =
                                     *                   =
                         * * *    ====                   =
                         ========                        =
                                                      ====
                                         =====           =
                                     *                   =
                         * * *      ====                 =
                         ========                        =
                                                         =
                                                         =
               ****                                      =
    ===============                                      =
                                                         =
                                                         =
                      ====================               =
                                                         =
                                                         =
    =======    =======                                   =
                   *               =====                 =
                *******                                  =
                   *                         ===         =
                   *                                     =
                                                         =
                                    ========             =
                                                         =
                               ===                       =
            *         =======                            =
            *                                            =
           ====                                          =
****                                                     =
========                         ====                    =
=                                                        =
=             *********                                  =
=       ====  ********* ====                             =
=             *********                                  =
=             *********                                  =
=               ====                                     =
=                                                  Q     =
==========================================================