#
#
#
#
#
#
                                                      ====
                                           ===           =
                                     *                   =
                           * *      ====                 =
                         ========                        =
                                                         =
                                                         =
          *****                                          =
    ===============                                      =
                                                         =
                         *************                   =
                      ====================               =
                                                         =
                                                         =
    =======    =======                                   =
                                                         =
                    * *                                  =
                                             ===         =
                                                         =
                                                         =
                                    ========             =
                                                         =
                    *                                    =
                *   * =======                            =
            *       *                                    =
          *  ==     *                                    =
         *          *               ====                 =
=      ==           *                                    =
                    *                                    =
                    *                                    =
 ======          =========      =====        ===         =
                                                         =
                                                         =
                                                         =
                                                         =
==========================================================