#
#
#
#
#
#
                                                         =
                                                         =
          ===     ====                                   =
                                        ==               =
    ===          =======        =====        ===      ====
            *                                            =
         =====        ====================               =
                                                         =
                                                         =
=    =    ===     ==========          =====              =
                                                         =
         *          * *                                  =
=    =    ===     ==========          =====              =
==                                                       =
     =    ===     ==========             =               =
                      ===               ==               =
         =====                      ======               =
            *                                            =
         =====        ====================               =
                                                         =
                                                         =
         *          * *                                  =
=    =    ===     ==========          =====              =
==                                                       =
===          E    E            E       E                 =
    ===          ============   =====        ===      ====
                                                         =
                                                         =
                                                         =
                                                         =
==========================================================