#
#
#
#
#
#
                                   
                                                        ==
                                         =====           =
                                     *                   =
                         * * *    ====                   =
                         ========                        =
                                                      ====
                                         =====           =
                                     *                   =
                         * * *      ====                 =
                                                        ==
                                         =====           =
                                     *                   =
                         * * *    ====                   =
                         ========                        =
                                                      ====
                                         =====           =
                                     *                   =
                         * * *      ====                 =
                                                        ==
                                         =====           =
                                     *                   =
                         * * *    ====                   =
                         ========                        =
                                                      ====
                                         =====           =
                                     *                   =
                         * * *      ====                 =
                         ========                        =
                                                         =
                                                         =
               ****                                      =
    ===============                                      =
                                                         =
                                                         =
                      ====================               =
                                                         =
                                                         =
    =======    =======                                   =
                   *               =====                 =
                *******                                  =
                   *                         ===         =
                   *                                     =
                                                         =
                                    ========             =
                                                         =
                               ===                       =
            *         =======                            =
            *                                            =
           ====                                          =
****                                                     =
========                         ====                    =
                                                         =
              *********                                  =
        ====  ********* ====                             =
              *********                                  =
              *********                                  =
                ====                                     =
                                                         =
==========================================================