#
#
#
#
#
#
                                                      ====
                                           ===           =
                                     *                   =
                         * * *      ====                 =
                         ========                        =
                                                         =
                                                         =
               ****                                      =
    ===============                                      =
                                                         =
                                                         =
                      ====================               =
                                                         =
                                                         =
    =======    =======                                   =
                   *                                     =
                *******                                  =
                   *                         ===         =
                   *                                     =
                                                         =
                                    ========             =
                                                         =
                                                         =
            *         =======                            =
            *                                            =
           ====                                          =
****                                                     =
========                         ====                    =
                                                         =
              *********                                  =
        ====            ====                             =
                                                         =
                                                         =
                ====                                     =
                                                         =
==========================================================